2 - старт, 3- стоит 4-выход
0 0 0 0 0 0 0 0 0 0 0 0 0 0 0 0 0 0 0
0 0 0 0 0 0 0 0 0 0 3 1 1 0 0 0 0 0 0
0 0 0 0 0 0 0 0 0 0 1 1 1 0 0 0 0 0 0
0 0 0 0 0 0 0 0 0 0 1 1 1 3 1 1 3 0 0
0 0 0 4 0 0 0 0 0 1 1 0 3 1 1 0 1 0 0
0 0 0 1 0 0 0 0 0 1 1 0 0 2 1 0 1 0 0
0 0 0 3 1 1 3 1 1 3 3 0 0 0 0 0 3 0 0
0 0 0 0 0 0 0 0 0 0 1 0 0 0 0 0 1 0 0
0 0 0 0 0 0 0 0 0 0 1 0 0 0 0 0 1 0 0
0 0 0 0 0 0 0 0 0 0 3 1 1 3 1 1 3 0 0
0 0 0 0 0 0 0 0 0 0 0 0 0 0 0 0 0 0 0
13 5 30