2 - старт, 3 - стоит, 5 - невидимый выход
0 0 0 0 0 0 0 0 0 0 0 0 0 0 0 0 0 0 0
0 0 0 0 1 1 3 0 0 0 0 1 5 0 0 0 0 0 0
0 0 0 0 1 1 3 1 1 0 0 1 1 0 0 0 0 0 0
0 0 0 0 0 0 3 1 1 0 3 1 1 0 0 0 0 0 0
0 0 0 0 2 1 3 0 0 1 1 1 1 3 0 0 0 0 0
0 1 0 0 0 0 1 0 0 1 1 0 0 1 0 0 0 0 0
0 1 0 0 0 0 3 1 1 3 0 0 0 1 0 0 0 0 0
0 3 1 1 3 0 0 3 1 1 3 1 1 3 0 0 0 0 0
0 0 0 0 1 1 1 1 0 0 0 0 0 0 0 0 0 0 0
0 0 0 0 1 1 1 1 0 0 0 0 0 0 0 0 0 0 0
0 0 0 0 0 0 0 0 0 0 0 0 0 0 0 0 0 0 0
4 4 30