строка комента     2 - вход  4 - переход в меню выбора уровней; 5 - переход на 5 уровень
0 0 0 0 0 0 0 0 0 0 3 1 1 3 0 0 0 0 0
0 0 0 0 0 0 0 0 0 0 1 0 0 2 1 1 3 0 0
0 1 3 1 1 3 0 4 0 0 1 1 5 3 0 0 1 0 0
1 1 1 0 0 1 0 1 0 0 3 0 0 3 0 0 1 0 0
1 1 1 0 0 1 1 3 0 0 1 0 0 3 1 1 3 0 0
3 2 1 0 3 3 1 0 1 1 3 1 1 3 0 0 0 0 0
0 0 0 0 1 1 0 0 1 1 3 0 0 3 1 1 0 0 0
0 0 0 0 1 1 0 0 0 0 0 0 0 3 1 1 0 0 0
0 0 0 0 0 0 0 0 0 0 0 0 0 0 0 0 0 0 0
0 0 0 0 0 0 0 0 0 0 0 0 0 0 0 0 0 0 0
0 0 0 0 0 0 0 0 0 0 0 0 0 0 0 0 0 0 0
0 0 30