строка комента     2 - вход  4 лево - переход в меню выбора уровней; 4 право - переход на 5 уровень
0 0 0 0 0 0 0 0 0 0 3 1 1 3 0 0 0 0 0
0 0 0 0 0 0 0 0 0 0 1 0 0 2 1 3 1 0 0
0 1 3 1 1 3 0 4 0 0 1 1 4 3 0 1 1 0 0
1 1 1 0 0 1 0 1 0 0 3 0 0 3 0 1 1 0 0
1 1 1 0 0 1 1 3 0 0 1 0 0 3 1 1 3 0 0
3 2 1 0 3 3 1 0 1 1 3 1 1 3 0 0 0 0 0
0 0 0 0 1 1 0 0 1 1 3 0 0 3 1 1 0 0 0
0 0 0 0 1 1 0 0 0 0 0 0 0 3 1 1 0 0 0
0 0 0 0 0 0 0 0 0 0 0 0 0 0 0 0 0 0 0
0 0 0 0 0 0 0 0 0 0 0 0 0 0 0 0 0 0 0
0 0 0 0 0 0 0 0 0 0 0 0 0 0 0 0 0 0 0
13 1 30